11111111111111
30002222222203
33322333000023
00020003233003
03333333300000
03022000020000
00002220022000
00000022222000
00000000003000
00000000000000
00000000000000
00000000000000
00000000000000
00000000000000
