11111111111111
10000000000001
10000000000001
10022000220001
10000000220001
10000000220001
10000000220001
10022000220001
10000000220001
10022000000001
10000000033331
10000000033331
15000000033331
11111111111111
