11111111111111
10000000002051
10000000002001
10022000002001
10022002202001
10000002200001
10000000000001
10022000033331
10022002234431
10000002234431
10000000034431
10002200034431
10000000033331
11111111111111
